1 What is the distribution of the species faecalibacterium prausnitzii in healthy reference?	SELECT AVG(count)  FROM abundance AS a JOIN HealthyStoolSamples AS m ON a.sample_id = m.sample_id WHERE a.species LIKE '%s__Faecalibacterium_prausnitzii';	(5.145465334211138,)	11.8552
2 What is the distribution(average level) of faecalibacterium prausnitzii in the database?	SELECT AVG(count)  FROM abundance AS a JOIN taxonomy AS t ON a.species = t.species WHERE t.genus = 'Faecalibacterium' AND t.species = 'Faecalibacterium_prausnitzii';	(None,)	18.0305
3 How many species have the histamine pathway (BioCyc ID: PWY-6173)?	SELECT COUNT(DISTINCT species) FROM chocophlan AS c JOIN reactions AS r ON c.uniref90 = r.uniref90 JOIN pathway AS p ON r.rxnid = p.rxnid WHERE p.pathway = 'PWY-6173';	(171,)	1.1697
4 How many samples belong to healthy patients?	SELECT COUNT(DISTINCT sample_id) FROM metadata WHERE metadata_column_name = 'disease' AND metadata_variable_content = 'healthy';	(14389,)	0.3869
5 How many samples are from vagina and to how many different studies they belong?	SELECT COUNT(DISTINCT m.sample_id) AS num_samples, COUNT(DISTINCT metadata_variable_content) AS num_studies FROM metadata AS m JOIN abundance AS a ON m.sample_id = a.sample_id WHERE m.metadata_column_name = 'body_site' AND m.metadata_variable_content = 'vagina';	(96, 1)	0.4988
6 How many species have a patient/sample on average?	SELECT AVG(COUNT(DISTINCT species)) FROM abundance;	Error executing query: misuse of aggregate function COUNT()	0.0
7 What's the average abundance of Firmicutes in the healthy samples from stool?	SELECT AVG(count) FROM abundance AS a JOIN HealthyStoolSamples AS m ON a.sample_id = m.sample_id JOIN taxonomy AS t ON a.species = t.species WHERE t.phylum = 'Firmicutes';	(None,)	66.8469
8 Looking for reference range for Helicobacter pylori in stool samples from Healthy patients. Is it 0-0?	SELECT AVG(count)  FROM abundance AS a JOIN HealthyStoolSamples AS m ON a.sample_id = m.sample_id WHERE a.species LIKE '%s__Helicobacter_pylori';	(5.4863294864843926e-05,)	13.2009
9 What are the most abundant species in non-healthy samples?	SELECT a.species, SUM(a.count) AS total_abundance FROM abundance AS a JOIN metadata AS m ON a.sample_id = m.sample_id WHERE m.metadata_column_name = 'disease'   AND m.metadata_variable_content != 'healthy' GROUP BY a.species ORDER BY total_abundance DESC LIMIT 10;	('s__Bacteroides_vulgatus', 63250.54426999995)	75.8559
10 What is the distribution (average level) of the sum of the species that have histamine pathway (PWY-6173) in healthy stool samples?    timeout error
11 What are the most three abundant species that belong to healthy samples and possess histamine pathway PWY-6173?	SELECT species, SUM(abundance.count) as total_abundance FROM abundance JOIN ip2mc ON abundance.species=ip2mc.ip_id JOIN pathway ON pathway.pathway_id=ip2mc.pathway  JOIN HealthyStoolSamples ON HealthyStoolSamples.sample_id=abundance.sample_id WHERE pathway.pathway = 'PWY-6173' GROUP BY species ORDER BY total_abundance DESC LIMIT 3;	Error executing query: no such column: pathway.pathway_id	0.0
12 What's the average abundance of Bacteroides in the healthy samples from stool?	SELECT AVG(count) FROM abundance AS a JOIN HealthyStoolSamples AS m ON a.sample_id = m.sample_id WHERE a.species LIKE '%g__Bacteroides%';	(0.001960316009604213,)	12.8471
13 timeout error
14 Are there any bacteria that belong to Lentisphaerae (Phylum section) in healthy stool samples? If so, how many?	SELECT COUNT(*)  FROM (   SELECT DISTINCT sample_id    FROM abundance    JOIN taxonomy ON abundance.species = taxonomy.species    JOIN HealthyStoolSamples ON abundance.sample_id = HealthyStoolSamples.sample_id    WHERE taxonomy.phylum = 'Lentisphaerae' ) AS LentisphaeraeSamples;	Error executing query: ambiguous column name: sample_id	0.0
15 timeout error
16 What is the average value of Prevotellaceae in healthy stool samples  in western population?	SELECT AVG(count) FROM abundance AS a JOIN HealthyStoolSamples AS m ON a.sample_id = m.sample_id  JOIN taxonomy AS t ON a.species = t.species WHERE t.family = 'Prevotellaceae' AND m.metadata_variable_content like 'western%';	(None,)	0.0006
17 How many non-healthy samples are there and how many different conditions do they belong to?	SELECT COUNT(DISTINCT metadata_variable_content) AS num_conditions, COUNT(*) AS num_non_healthy_samples FROM metadata WHERE metadata_column_name = 'disease'   AND metadata_variable_content != 'healthy';	(141, 8022)	0.3290
18 GABA degradation pathway (4AMINOBUTMETAB-PWY): how many species possess it?	SELECT COUNT(DISTINCT c.species) FROM chocophlan AS c JOIN reactions AS r ON c.uniref90 = r.uniref90 JOIN pathway AS p ON r.rxnid = p.rxnid WHERE p.pathway = '4AMINOBUTMETAB-PWY';	(2967,)	1.3567
19 What is the average level of Lactobacilli in healthy stool samples?	SELECT AVG(count)  FROM abundance AS a JOIN HealthyStoolSamples AS m ON a.sample_id = m.sample_id WHERE a.species LIKE '%s__Lactobacillus%';	(0.005581597788130528,)	29.5970
20 timeout error